nazwisko=nickname
imię=first name
złodziej sklepowy=shoplifter
rękaw=sleeve
opaska do włosów=hairband
płaszcz=coat
rozpinany sweter=cardigan
znudzony=bored
aktywny=active
miejsce akcji=setting
Co grają?=What's on?
przebój kinowy=blockbuster
reżyser=director
napisać scenariusz=write a script
film animowany=animated film
płaszcz przeciwdeszczowy=raincoat
kaptur=hood
bluza polarowa=fleece
bluzka=blouse
w kratę=checked
w kropki=dotted
atrakcyjny=attractive
przystojny=handsome
ciemne włosy=dark hair
bluza z kapturem=hoodie
nosić (np. ubrania)=to wear
pasek=belt
kręcone włosy=curly hair
dorosły=adult
kolczyki=earings
złodziej=thief
fabuła=plot
średni=average
kolonizować=colonise
kinoman=film buff
napisy=subtitles
obrazy generowane komputerowo=computer-generated imagery
kosmita=alien
Fabuła była tak interesująca.=The plot was so interesting.
czapka zimowa=beanie
statysta=extra
modny=fashionable
filmowiec=film-maker
Oni są tak wspaniałymi aktorami.=They are such fantastic actors.
widownia=audience
kosmos=space
Czy chciałbyś coś zjeść?=Would you like something to eat?
duży ekran=big screen
kostiumograf=costume designer
oparty na=based on
Może kupię dwa bilety na koncert?=Shall i buy two tickets to a concert?
dreszczowiec=thriller
cyfrowy=digital
przedszkole=kindergarten
aktor drugoplanowy=supporting actor
istnieć=exist
zainspirować=inspire
nakręcić film=shoot a film
nagłówek=headline
ekran/sala kinowa=screen
przemysł filmowy=film industry
dziać się=take place
recenzent=reviewer
torebka=handbag
film niemy=silent film
obsada=cast
brunet, brunetka=brunette
komedia romantyczna=rom-com
sportowiec=athlete
wizażysta=make-up-artist
okres=period
Co powiesz na pójście do muzeum?=How about visiting a museum?
włączając=including
strój=outfit
przechwytywanie ruchów=motion capture
blond włosy=blonde hair
reklama=advert
film akcji=action film
film fantasy=fantasy film
cel=purpose
szczególnie=especially
bilety ulgowe=concessions
Czy chciałbyś pójść do restauracji dziś po południu?=Would you like to go to a restaurant this afternoon?
montować film=edit the film
miejsce=seat
tłumaczyć=explain
efekt specjalny=special effect
To taka interesująca książką.=It's such an exciting book.
rozwijać=develop
w podeszłym wieku=elderly
wiek=century
szpieg=spy
podziwiać=admire
łysy=bald
musical=musical
broda=beard
aktor pierwszoplanowy=lead actor
nagrywać ścieżkę dźwiękową=record a soundtrack
Może spotkamy się w parku?=Why don't we meet in a park?
znany z=famous for
kontynuacja=sequel
naoczny świadek=witness
ofiara=victim
przemoc=violence
wandal=vandal
napadać (w miejscu publicznym)=to mug
włamać się do domu=to break into a house
aresztować=to arrest
wandalizm=vandalism
więzienie=prison
funkcjonariusz policji=police officer
piractwo=piracy
kradzież kieszonkowa=pickpocketing
więzień=prisoner
morderca=murderer
morderstwo=murder
rozbój=mugging
kieszonkowiec=pickpocket
zabójca=killer
porwanie=kidnapping
porywacz=kidnapper
winny=guilty
bandyta uliczny=mugger
przestępstwo=crime
kradzież z włamaniem=burglary
kryminalista=criminal
przestępca napadający na bank=bank robber
napad na bank=bank robbery
osoba znęcająca się nad słabszymi=bully
znęcanie się nad słabszymi, tyranizowanie=bullying
alarm antywłamaniowy=burglar alarm
bez wzorów=plain
wchodzić do kin=come out
główny bohater=main character
recenzja=review
polecać=recommend
film o dzikim zachodzie=western
budżet=budget
rozmowa o pracę=job interview
przedstawiać=introduce
rzeczy zagubione=lost property
ślady stóp=footprints
portret pamięciowy=identikit
tożsamość=identity
uścisk, przytulać=hug
krępujący=embarrassing
sklep z pączkami=doughtnut shop
ścinać=cut down
wagon=coach
klapki, japonki=flip-flops
z krótkim rękawem=short-sleeved
swobodny, codzienny=casual
busz=bushland
uwaga=attention
zakłopotany=embarrassed
podpalenie=arson
uciekać=run away
iść do więzienia=go to prison
podpalacz=arsonist
popełnić przestępstwo=commit a crime
gonić=chase
kraść=steal
Jest zrobiony z...=It's made of...
uszkodzić=damage
skórzana kurtka=leather jacket
wyruszać=set off
wystartować=take off
wejść do=get on
wysiąść z=get off
wsiąść do=get in
rozkład jazdy=timetable
wyjść z=get off
bilet powrotny=return ticket
peron=platform
podróżować za granicę=travel abroad
bilet w jedną stronę=single ticket
nocować w pensjonacie ze śniadaniem=stay at B&B
zwiedzać=see the sights
rozbić namiot=put up a tent
nocować w schronisku dla młodzieży/hostelu=stay at a youth hostel
zarezerwować swój lot=book your flight
kupować pamiątki=buy souvenirs
zameldować się w hotelu=check in to a hotel
wyruszać na pieszą wycieczkę=go hiking
wyruszać na wędrówkę z plecakiem=go backpacking
pomnik, zabytek=monument
buty trekingowe=hiking boots
wyjazd za miasto=city break
rower jednokołowy=unicycle
lista rzeczy do zrobienia=to-do list
krem do opalania=sun cream
To tylko 5 minut piechotą.=It's just a five-minute walk.
cel podróży=destination
zjeżdżalnia=slide
Nie da się go przegapić!=You can't miss it!
Idż prosto=Go straight on
ogłoszenie=announcement
projektować=design
wystawiać=exhibit
ulepszenie=improvement
instalacja=installation
produkować=produce
rzeźba=sculpture
projektowanie mody=fashion design
stworzyć rzeźbę=make a sculpture
portret=portrait
rzeźbiarz=sculptor
dzieło sztuki=work of art
płacić gotówka=pay in cash
płacić zblizeniowo=pay contactless
paragon=receipt
przepis=recipie
bezprzewodowy=wireless
urzadzenie=appliance
tajemniczy klient=mystery shopper
okazja=bargain
dzieło, stworzenie=creation
Ale świetny pomysł!=What an amazing idea!
cieszyć się popularnością u=be popular with
Cóż za wspaniałe osiągnięcie!=What a great achievement!
współczesny=contemporary
tektura=cardboard
miedziany=copper
Dałem/am z siebie wszystko!=I did my best!
Trzymam kciuki za ciebie!=I'm keeping my fingers crossed for you!
uzdolniony=gifted
stawiać sobie wyzwania=to challenge oneself
zdobywać wiedzę=to gain knowledge
zajęcia dodatkowe (pozaszkolne)=extra-curricular activities
lubić coś robić=to be keen on doing something
dres=tracksuit
utrzymać (dobrą) formę, być w dobrej formie=to stay fit
ćwiczyć na siłowni=to work out in the gym
zdrowe nawyki=healthy habits
wyznaczać cele=to set goals
zdrzemnąć się=to take a nap
maniak ćwiczeń fizycznych=fitness freak
wskaźnik masy ciała, BMI=body mass index
zapięcie rowerowe=bike lock
być czegoś fanem=to be a fan of something
być w czymś dobrym=to be good at something
bardzo coś lubić=to be fond of something
przepadać za czymś, być zapalonym do czegoś=to be keen on something
interesować się czymś=to be interested in something
ćwiczyć, wykonywać ćwiczenia fizyczne=to work out
pasjonować się czymś=to be passionate about something
sztuki walki=martial arts
ćwiczenia siłowe=weight training
podnosić ciężary=to lift weights
ogrodnictwo=gardening
znaleźć nowe zainteresowania=to take up new hobbies
rozwiązywać krzyżówki=to do crosswords
jazda na skuterze wodnym=jet-skiing
nurkowanie (z rurką do oddychania)=snorkelling
siatkówka plażowa=beach volleyball
kask=helmet
bramka=goal
kij (do baseballa)=bat
łyżwy=ice skates
nurkowanie=diving
siatka=net
rakieta do tenisa=tennis racket
czepek=swimming cap
kostium kąpielowy=swimsuit
kąpielówki=swimming trunks
gra w kręgle=bowling
wyścigi samochodowe=car racing
uprawiać lekkoatletykę=to do athletics
łucznictwo=archery
wioślarstwo=rowing
szermierka=fencing
uprawiać sztuki walki=to do martial arts
zapasy=wrestling
kijki=poles
skoki na linie z dużej wysokości=bungee jumping
nurkowanie jaskiniowe=cave diving
narciarstwo ekstremalne=extreme skiing
kolarstwo górskie=mountain biking
podnoszenie ciężarów=weightlifting
kij golfowy=golf club
kij do hokeja=hockey stick
skok wzwyż=high jump
skok w dal=long jump
rzut młotem=hammer throwing
płotek=hurdle
lotka do badmintona=shuttlecock
paletka do ping-ponga=table tennis bat
krążek hokejowy=puck
kajakarstwo=canoeing
narty=skis
pianka do nurkowania=wetsuit
kij bilardowy=cue
skok o tyczce=pole vault
rzut oszczepem=javelin
rzut dyskiem=discus
paralotniarstwo=hang-gliding
wspinaczka górska bez zabezpieczenia=free climbing
mocno się starać=to do one's best
zapobiegać=prevent
uraz=injury
zranić sie=get hurt
ćwiczyć technike=practise your technique
rozciągać sie=stretch
rozgrzewać sie=warm up
lodowisko=ice rink
boisko do koszykówki=basketball court
stok=slope
boisko do piłki nożnej=football pitch
boisko do rugby=rugby field
tor wyścigowy=racing track
pobić, pokonać=beat
pobić rekord=break a record
łamać zasady=break rules
łapać, chwytac=catch
zremisować, remis=draw
mistrzostwa=championship
faul, sfaulować=foul
przeciwnik=opponent
sędzia, arbiter=referee
grać według zasad=play by the rules
ustanowić rekord=set a record
kibic=supporter
turniej=tournament
wózek inwalidzki=wheelchair
zawodnik=competitor
rywalizować=compete
wzrok=vision
mieć pozwolenie=be allowed to
podejmować decyzję=make a decision
